12 12
2 2 2 2 2 2 2 2 2 2 2 2
2 2 1 1 1 1 1 1 1 1 1 2
2 1 1 0 0 0 0 0 0 0 1 2
2 1 0 0 0 0 5 0 0 0 1 2
2 1 0 0 0 0 0 0 0 0 1 2
2 1 0 0 4 3 4 4 4 0 1 2
2 1 0 5 4 3 3 3 4 0 1 2
2 1 0 0 4 3 3 3 4 0 1 2
2 1 0 0 4 4 4 4 4 0 1 2
2 1 0 0 0 0 0 0 0 0 1 2
2 1 1 1 1 1 1 1 1 1 1 2
2 2 2 2 2 2 2 2 2 2 2 2
